02.lvl
grass.model
########
#g     #
#+++   #
#      #
#      #
#    ++#
#c ^   #
#++++  #
#>   ^^#
#cc++++#
#>     #
#+++++ #
#  p   #
########
