02
floor
########
#g     #
#+++   #
#      #
#      #
#    ++#
#c ^p  #
#++++  #
#>   ^^#
#cc++++#
#>     #
#+++++ #
#      #
########
