02
assets/sounds/01_music.wav
models/01/floor
########
#g c+++#
#++c  >#
#> c+++#
#++c  >#
#  c+++#
#c >   #
#++++c+#
#>    <#
#cc++++#
#>     #
#+++++ #
#p F f^#
########
