########
#      #
# +>   #
#  +   #
#      #
#  >   #
#  >+  #
#  +s  #
########
