04
assets/sounds/02_music.wav
models/03/floor
#########
#g  c   #
# +c+c+ #
# c c   #
#c+c+c+ #
# c c c #
# + +c+ #
#c ^  c #
# +c+ + #
#>   ^> #
#c+ + + #
#>  c   #
#c+ +c+ #
#> ^   p#
#########
