05
assets/sounds/02_music.wav
models/04/floor
#########
#g  c   #
#  c+c+c#
# c c c #
#c+c+c+c#
# c c c #
#^+c+c+ #
#c ^    #
#c+c+ + #
#>   ^ ^#
#c+c+ + #
#>      #
#c+c+ + #
# c    p#
#########
