06
assets/sounds/03_music.wav
models/04/floor
#############
#g>         #
#++++++++++c#
#>        + #
#c+++++++ + #
# +>   c+c+ #
# +c+++ + + #
#^+^+p+^+^+^#
# + +  c+ + #
# + +++++c+ #
# +>      + #
# +++++++++c#
#>          #
#############
