07
assets/sounds/03_music.wav
models/03/floor
#########
#g     >#
# + + + #
#>     ^#
# + + + #
#^     >#
# + + + #
#c ^   >#
# + + + #
#>   ^  #
#c+ + + #
#>      #
# + + + #
#      p#
#########
