08
assets/sounds/04_music.wav
models/02/floor
#########
#g ^ ^  #
#++c+c++#
# +^>^+ #
#++c+c++#
#>>^+^>>#
#++c+c++#
# +^>^+ #
#++c+c++#
#>>^+^>>#
#++c+c++#
# +^>^+ #
# +c+c+ #
#      p#
#########
