01
assets/sounds/04_music.wav
models/01/floor
#################################
# cc    cc   ccc    cc     cc   #
#  cc  cc   cc cc   cc     cc   #
#   cccc   cc   cc  cc     cc   #
#    cc   cc     cc cc     cc   #
#    cc   cc     cc cc     cc   #
#    cc    cc   cc   cc   cc    #
#    cc     cc cc     cc cc     #
#    cc      ccc       ccc      #
#                               #
#   p                           #
#                               #
# cc   cc    cc  cc  cc      cc #
# cc   cc    cc  cc  ccc     cc #
# cc   cc    cc  cc  cc cc   cc #
# cc   cc    cc  cc  cc  cc  cc #
# cc   cc    cc  cc  cc   cc cc #
#  cc cc cc cc   cc  cc    cccc #
#   ccc   ccc    cc  cc     ccc #
#################################
